1111111111111
1PC00C0110111
1000000000001
1000000000001
1000000000001
1000000000001
1000000000001
1000000000001
1111E11100001
1111111111111