11111111111
1P0000110C1
10000C11011