11111111111
1PC0E0110C1
10000CC1101
11111111111