1111111111111
1PC01C0110111
1111E11100001
1111111111111